6 9
#########
#P..$..B#
#.##.##*#
#.##.##.#
#D..A..R#
#########
LRDD
2 1 1 7 7
UULRDD

